R 400 400
NO ./textures/bluestone.xpm
SO ./textures/redbrick.xpm
WE ./textures/greystone.xpm
EA ./textures/mossy.xpm

S ./textures/barrel.xpm
F ./textures/wood.xpm
C ./textures/bluestone.xpm

11111111111111111111
10000000000555550001
10000002220555550001
10000000000555550001
10000000000555550001
10N00000000555550001
10000000000000000001
10000044444444440001
11111111111111111111
