R 400 400
NO ./textures/bluestone.xpm
SO ./textures/redbrick.xpm
WE ./textures/greystone.xpm
EA ./textures/mossy.xpm

S ./textures/barrel.xpm
F ./textures/wood.xpm
C ./textures/bluestone.xpm

11111111111111111111
10000044444444444441
10000044444444444441
10000044444444444441
10000044444444444441
10N00044444444444441
10000044444444444441
10000044444444444441
11111111111111111111
