R 567 678
NO ./textures/robot_n.xpm
SO ./textures/robot_s.xpm
WE ./textures/robot_w.xpm
EA ./textures/robot_e.xpm

S ./textures/barrel.xpm
F ./textures/robot_f.xpm
C ./textures/skybox.xpm

1111111111111111111111111111111111111111111111111111111
1000000000000000000000000000000000000000000000000000001
1000000200000000000000000000000000000000000000000000001
1000000002030100000000000000000000000000000000000000001
1000000600000000000000000000000000000000000000000000001
10E0000000000222000000000000000000000000000000000000001
1000000000333000000000000000000000000000000000000000001
1000000444000000000000000000000000000000000000000000001
1000555000000000000000000000000000000000000000000000001
1000000000000000000000000000000000000000000000000000001
1000000000000000000000000000000000000000000000000000001
1000000000000000000000000000000000000000000000000000001
1000000000000000000000000000000000000000000000000000001
1000000000000000000000000000000000000000000000000000001
1000000000000000000000000000000000000000000000000000001
1000000000000000000000000000000000000000000000000000001
1000000000000000000000000000000000000000000000000000001
1000000000000000000000000000000000000000000000000000001
1000000000000000000000000000000000000000000000000000001
1111111111111111111111111111111111111111111111111111111
