R 400 400
NO ./textures/wall_n.xpm
SO ./textures/wall_s.xpm
WE ./textures/wall_w.xpm
EA ./textures/wall_e.xpm

S ./textures/barrel.xpm
F 4, 255, 22
C 255,255,255 

11111111111111111111
10000000000000000001
10000002220000000001
10000000000000000001
10000000000000000001
10N00000000000000001
10000000000000000001
10000000000000000001
11111111111111111111
