R 1024 768
NO ./textures/wall_n.xpm
SO ./textures/wall_s.xpm
WE ./textures/wall_w.xpm
EA ./textures/wall_e.xpm

S ./textures/barrel.xpm
F ./textures/wood.xpm
C ./textures/bluestone.xpm

11111111111111111111
10000000000000000001
10000234000000000001
10000000000000000001
10000000000000000001
10W00000000000000001
10000000000000000001
10000000000000000001
11111111111111111111
