R 1920 1080
NO ../textrues/wall_n.xpm
SO ../textures/wall_s.xpm
WE ../textures/wall_w.xpm
EA ../textures/wall_e.xpm

S ../textures/barrel.xpm
F ../textures/eagle.xpm
C ../textures/wood.xpm

11111111111111111111
10000000000000000001
10000000000000000001
10000000000000000001
10000000000000000001
10000000000000000001
10000000000000000001
10000000000000000001
11111111111111111111
