R 567 678
NO ./textures/tex1.xpm
SO ./textures/tex7.xpm
WE ./textures/tex4.xpm
EA ./textures/tex5.xpm

S ./textures/sprite1.xpm
F ./textures/tex8.xpm
C ./textures/skybox.xpm

11111111111111111111
10000033333333333331
10000000000000000001
10600000005000400201
10000000000000000001
10N00000005000400201
10000000000000000001
10000000005000400201
11111111111111111111
