R 800 800
NO ./textures/robot_n.xpm
SO ./textures/robot_s.xpm 
WE ./textures/robot_w.xpm
EA ./textures/robot_e.xpm
S ./textures/sprite1.xpm
F ./textures/robot_f.xpm
C ./textures/robot_c.xpm

        1111111111111111111111111
        1000000300110000000000041
        1011003001110000030000041
        1021030000000000000000041
111111111041000001110000000000041
100000000011000001110111111111111
11110111111111011100003000001
11110111111111011100000010001
11000040110101011130000010001
15000040000000051100000010601
15000000000330000000101001001
11500001110101011111011110N0111
11110111 1110121 101111010001
11111111 1111111 111111111111
