R 400 400
NO ./textures/tex1.xpm
SO ./textures/tex7.xpm
WE ./textures/tex4.xpm
EA ./textures/tex5.xpm

S ./textures/sprite1.xpm
F ./textures/tex8.xpm
C ./textures/tex6.xpm

11111111111111111111
10000033333333333331
10000000000000000001
10600000000000000001
10000000000000000001
10N00000000000000001
10000000000000000001
10000000000000000001
11111111111111111111
