R 801 801
NO ./textures/tex1.xpm
SO ./textures/tex3.xpm 
WE ./textures/tex2.xpm
EA ./textures/tex7.xpm
S ./textures/sprite2.xpm
F 255, 0, 0
C 0, 0, 255

        1111111111111111111111111
        1000000000110000000000001
        1011000001110000000000001
        1001000000000000000000001
111111111001000001110000000000001
100000000011000001110111111111111
11110111111111011100000000001
11110111111111011100000010001
11000000110101011100000010001
10000000000000001100000010001
10000000000000000001010010001
11000001110101011111011110N0111
11110111 1110121 101111010001
11111111 1111111 111111111111
