R 400 300
NO ./textures/eagle.xpm
SO ./textures/colorstone.xpm
WE ./textures/redbrick.xpm
EA ./textures/mossy.xpm

S ./textures/barrel.xpm
F ./textures/wood.xpm
C ./textures/skybox.xpm

1111111111111111111111111111111111111111111111111111111
1000000000000000000000000000000000000000000000000000001
1000000200000000000000000000000000000000000000000000001
1000000002030100000000000000000000000000000000000000001
1000000600000000000000000000000000000000000000000000001
1000000000000222000000000000000000000000000000000000001
1000000000333000000000000000000000000000000000000000001
1000000444000000000000000000000000000000000000000000001
1000555000000000000000000000000000000000000000000000001
1000000000000000000000000000000000000000000000000000001
100S000000000000000000000000000000000000000000000000001
1000001111111111111111111111111111111111111111111111111
1000000000000000000000000000000000000000000000000000001
1011111000000000000000000000000000000000000000000000001
1000001000000000000000000000000000000000000000000000001
1011101000000000000000000000000000000000000000000000001
1010001000000000000000000000000000000000000000000000001
1011111000000000000000000000000000000000000000000000001
1000000000000000000000000000000000000000000000000000001
1111111111111111111111111111111111111111111111111111111
